   3333333333333333
     3 1  2   1 3 3
      3   2    3  3
3      3      3 1 3
3       4    3   13
3       4   3     3
3    4   4 3   4  3
3      	  3       3
3                 3
3            222223
3                 3
3                 3
3     3     3     3
3    3       3   13
3   3    2    3 1 3
3  31    2    13  3
3 3  1   2   1  3 3
3333333333333333333